24 16
175  175  175  175  171  132  132  132  171  132  132  132  132  121  132  132  132  121  132  121  121  171  132  132
175  175  132  132  132  132  132  132  132  132  132  132  132  132  121  121  121  132  132  132  132  121  121  121
175  132  132  144  144  144  144  144  144  144  144  144  144  144  144  144  144  144  144  144  132  132  171  171
132  132  132  144  132  132  132  132  132  132  132  132  132  132  132  132  132  132  132  144  144  132  132  132
132  132  132  144  132  132  132  132  132  132  132   59   68   59  132  132  132  132  132  132  144  132  132  171
132  132  132  144  132   37   67   92  132  132  132  132  132  132  132  132  132  132  132  132  144  132  132  132
132  132  132  144  144  144  132  132  132  132  132  132  114  132  132  132  132    4   67   77  144  132  132  132
132  132  132  144   37  144  132  132  132  132  132  132  132  132  132  132  132  132  132  132  144  132  132  132
132  132  132  144   70  144  132  132  132  132  132  132  132  132  132  132  132  132  132  132  144  132  132  132
132  132  132  144   59  144  132  132  132  132  132  132  132  132  132  144  144  144  144  144  144  144  132  132
132  171  132  144   67  144  132  132  132  144  147  144  132  132  132  144   37   67   91   70   37  144  132  132
132  132  132  144   71  144  132  132  132  144  121  144  132  132  132  144   68  144  144  144   67  144  132  132
132  171  132  144   77  144  132  132  132  144  121  144  132  132  132  144   37  144   34   67   78  144  132  132
171  132  171  144  144  144  144  144  144  144  121  144  144  144  144  144  144  144  144  144  144  144  171  175
132  132  132  171  132  132  171  132  171  132  121  132  132  132  121  121  121  132  132  132  132  175  175  175
171  171  132  132  132  171  132  132  132  132  121  121  121  121  132  132  121  121  132  132  175  175  175   86
